11111111111111111111
1000CCCC0001CCCCCCC1
100ECCCC0001CCCCCCC1
1000CCCC0001CCCCCCC1
1000CCCC0001CCCCCCC1
1000CCCC0001CCCCCCC1
1000CCCC0001CCCCCCC1
1000CCCC0001CCCCCCC1
1000CCCC0001CCCCCCC1
1000CCCC0001CCCCCCC1
1000CCCC0001CCCCCCC1
1000CCCC0001CCCCCCC1
1000CCCC0001CCCCCCC1
1000CCCC0001CCCCCCC1
1000CCCC0000CCCCCCC1
1000CCCC0001CCPCCCC1
1000CCCC0001CCCCCCC1
1000CCCC0001CCCCCCC1
11111111111111111111