111111111111111
1BBBBBBBBBBBBB1
1BBBBBBBBBBBBB1
1BBBBBBBBBBBBB1
1BBBBBBBBBBBBB1
1BBBBBBBBBBBBB1
1BBPBBBBBBBB111
1BBCBBBBBBBBBB1
1BBEBBB1BBBBBB1
111111111111111