1111111
1PC0B01
10BC111
1B00CE1
1111111